0000000000
0000000000
0000000000
0000000000
0000100000
0000001000
0000100000
0000001000
0000100000
0000001000
0000100000
0000001000
0000100000
0000001000
0000100000
0000001000
0000100000
0000001000
0000100000
0000001000